Westmoreland County 	Virginia
Braintree 	Massachusetts
Shadwell 	Virginia
Port Conway 	Virginia
Monroe Hall 	Virginia
Braintree 	Massachusetts
Waxhaws Region 	South/North Carolina
Kinderhook 	New York 	
Charles City County 	Virginia
Charles City County 	Virginia 	
Pineville 	North Carolina 	
Barboursville 	Virginia 
Summerhill 	New York 	
Hillsborough 	New Hampshire 	
Cove Gap 	Pennsylvania 
Raleigh 	North Carolina 	
Sinking Spring 	Kentucky 	
Point Pleasant 	Ohio 	
Delaware 	Ohio 	
Moreland Hills 	Ohio 	
Fairfield 	Vermont 	
Caldwell 	New Jersey 	
North Bend 	Ohio 	
Caldwell	New Jersey	
Niles 	Ohio 	
New York City 	New York 	
Cincinnati 	Ohio 	
Staunton 	Virginia 	
Blooming Grove 	Ohio 	
Plymouth 	Vermont 	
West Branch 	Iowa 	
Hyde Park 	New York 	
Lamar 	Missouri 	
Denison 	Texas 	
Brookline 	Massachusetts 	
Stonewall 	Texas 	
Yorba Linda 	California 	
Omaha 	Nebraska 	
Plains 	Georgia 	
Tampico 	Illinois 	
Milton 	Massachusetts 	
Hope 	Arkansas 	
New Haven 	Connecticut 	
Honolulu 	Hawaii 	
New York City 	New York 	